C 220,100,222

F 1,225,0

NO blue.xpm

SO ./green.xpm

WE ./yellow.xpm

EA ./red.xpm

111111111111111111111
110000000000000000001
100000000N00000000001
100010000000100000001
100000000010000000001
111111111111111111111
