C 220,100,222

F 1,225,0

NO blue.xpm

SO ./green.xpm

WE ./yellow.xpm

EA ./red.xpm

1111111111
1111111111111111111111
            1N0000000111111111111111111111111111
11111111111111111111111111111
10000000001001       100000001
111111111111111111111111111111111