C 220,100,222

F 225,30,0

NO ./blue.xpm

SO ./blue.xpm

WE ./blue.xpm

EA ./blue.xpm

111111111111111111111111100000001
100000000011000000000000100000001
101100000111000000000000100000001
100100000000000000000000100000011
111111111011000001110000000000001
100000000011000001110111111111111
111101111111110111000000100010001
111101111111110111010100100010001
110000001101010111000000100010001
100000000000000011000000100010001
100000000000000011010100100010001
11000001110101011111011110N011101
111101111110101101111010001000111
111111111111111111111111111111111